&&&&&&&&&&&&&&&&&&&&&&&&&&&&&&&&&&&&&&&&&&&&&&&&&&&
......&&&..........................................
......&&&..........................................
......&&&..........................................
......&&&..........................................
......&&&..........................................
...................................................
...................................................
...................................................
...................................................
......&&&&......................................4..
......&&&&~~~~~~~~~~~~~~~~~&&&&&...&&&&.........&&&
......&&&&.................&&&&&...&&&&.........&&&
......&&&&.................&&&&&...&&&&.........&&&
&&&&&&&&&&&&&&&&&&&&&&&&&&&&&&&&&&&&&&&&&&&&&&&&&&&
