....................
....................
....................
....................
....................
....................
....................
.....1...GXG...2....
.........###........
....................
....GGG.......GGG...
....###.......###...
....................
....................
####################
