&&&&&&&&&&&&&&&&&&&&&&&&&&&&&&&&&&&&&&&&&&&&&&&&&&&
&&&...............&&&&&&..................&&&......
&&&...............&&&&&&..................&&&......
&&&...............&&&&&&..................&&&......
&&&...............&&&&&&..................&&&......
..........................................&&&......
...................................................
...................................................
...................................................
...................................................
..1...................................E..&&&&......
&&&.........&&&&...&&&&&~~~~~~~~~~~~~~~~~&&&&......
&&&.........&&&&...&&&&&.................&&&&......
&&&.........&&&&...&&&&&.................&&&&......
&&&&&&&&&&&&&&&&&&&&&&&&&&&&&&&&&&&&&&&&&&&&&&&&&&&
