....................
..........X.........
....................
....................
....................
....................
....................
.....1...GGG...2....
.........###........
....................
....GGG.......GGG...
....###.......###...
....................
....................
####################
