.......................................
.......................................
.......................................
.......................................
.......................................
.......................................
Q.......................3...........4.X
@@@@@@@@@@@@@@@@@....@@@@@@@@@@@@@@@@@@
@@@@@@@@@@@@................@@@@@@@@@@@
@@@@@@@@@@....................@@@@@@@@@
@@@@@@@@........................@@@@@@@
@@@@@@............................@@@@@
@@@@@..............................@@@@
@@@@@^^^^^^^^^^^^^^^^^^^^^^^^^^^^^^@@@@
@@@@@@@@@@@@@@@@@@@@@@@@@@@@@@@@@@@@@@@
c 