###################################################
###...............######..................###......
###...............######..................###......
###...............######..................###......
###...............######..................###......
..........................................###......
...................................................
...................................................
...................................................
...................................................
..1......................................####......
###.........####...#####~~~~~~~~~~~~~~~~~####......
###.........####...#####.................####......
###.........####...#####.................####......
###################################################
