###################################################
......###..........................................
......###..........................................
......###..........................................
......###..........................................
......###..........................................
...................................................
...................................................
...................................................
...................................................
......####......................................4..
......####~~~~~~~~~~~~~~~~~#####...####.........###
......####.................#####...####.........###
......####.................#####...####.........###
###################################################
